% quite, rather, pretty, fairly
这组词都有“相当，颇”的意思，其区别是：
- quite: 含义比fairly稍强，与不定冠词连用时，一般放在不定冠词之前。
- rather: 语气比quite强，褒意贬意无可使用。可与too和比较级连用。
- pretty: 用法与rather相似。常用于非正式文体。
- fairly: 语意最弱，多用于褒义，表示适度地、尚可的意思。不可与too或比较级连用。

% repeal, delete, cancel, abolish
- repeal: 书面用词，指撤销立法机关通过的协议、法案或法律等。
- delete: vt. 删除
- cancel: 用法广泛，多指取消债务、合同、证书、比赛、旅行、计划或约会等。
- abolish: 正式用词，指彻底废除某种制度、规章或习俗。

% constrain, force, compel, oblige
这组词都有“迫使”的意思，其区别是：
- constrain: 侧重施加约束力或有约束作用的影响，也指环境对人强加的影响迫使人去做某事，尤指受良心、情感等内在力量驱使去做某事。
- force: 指用个人意志、权力、权威或暴力等，迫使他人改变看法或做本不愿做的事。
- compel: 指在法律、权力、力量或行动等的驱使下被迫而为。
- oblige: 指由于生理上或道德上的需要，促使某人做某事，也指有权威的人或机构迫使某人做某事，还可指在特定情况下被迫作出的反应。

% attitude, manner, air
这组词都有“态度、风度”的意思，其区别是：
- attitude: 普通用词，指对人或事情的看法和采取的行为，多有某种不很明确或不便明说的感情色彩。
- manner: 多指某人在某一场合的言谈举止等。
- air: 含义广泛。单数形式指某人脸上表现出的心理活动，或言谈举止；复数形式指某人故意做作而摆出的架子。

% pause, stop, break, interval, cease, recess, rest
这组词都有“中止，停止，休息”的意思，其区别是：
- pause: 指短暂的中断或停止，含再进行下去的意味。
- stop: 普通用词，指迅速或突然中止某行为、活动或状态。
- break: 非正式用词，指突然的或短时间的中止，如工作或活动期间接短暂休息。
- interval: 指一出戏在幕与幕之间，音乐会上下串场之间或演出中预先安排的休息；也可泛指事件之间的一段时间。
- cease: 正式用词，侧重逐渐结呸某活动或状态，含永远结束的意味。
- recess: 正式用词，指业务活动或工作中短暂的或长时间的休息。
- rest: 指统称的休息。

% compound, blend, combination, mixture, composite
这组词都有“混合”的意思，其区别是：
- compound: 特指两种或多种元素构成的化合物。
- blend: 侧重混合成分之间的类似和整个混合物的统一性。
- combination: 指相混元素的紧密结合，但不一定的是融合。
- mixture: 普通用词，指不同类种、性质不同的事物的混合。
- composite: 通常可与compound换用，但倾向于指人为的或偶然的结合或凑合。

% humanity, mankind, man
这组词都有“人类”的意思，其区别是：
- humanity: 书面用词，集合名词，多用于文学作品中，作人类解时，侧重有同情心、理解力和崇高品质。
- mankind: 集体名词，语体庄重，泛指过去、现在和未来的人类。
- man: 指各时代的全体人类。